
                                   ▲ COMMERCIAL CLASS
_______________________________        _________________________
______________|   {item}                         |______________
______________|                         _________|______________
______________|        --[ BATHROOM ]--|   ___   |______________
______________|                        |  |   |  |______________
______________|                        |  |   J  |______________
______________| |   _   |              |  |   |   |_____________
______________| |__| |__|              |   ___   |______________
________________________________________________________________